#############
#       #   #
##### # # ###
#   # # #   #
# ### # # # #
# #   # # # #
# ### # ### #
#     #   # #
######### # #
# #     # # #
# # ### # # #
#     #     #
#############